1111111111111
10010000000C0
1000011111000
1P0011E000001
1111111111111