1111111111111111111111111111111111111111111111111111111111111111111111111111111111111111111111111111111111111111111111111111111111
10010000000000000000000001111111111000000000000000000000000000000000000000000000000000000000000000000000000000000000000000000000C1
1000011111000000000000000000000000000000000000000000000000000000000000000000000000000000000000000000000000000000000000000111111111
1P00110000001000000000000000000000000000000000000000000000C111111111111111111111111111C1000000000000000011111100000000000000000001
1000000000000000000000000000000000000000000000000000000000000000000000000000000000000000000000000000010010000000000000000000000001
10000000000000000000000000000000000000000000000000000C0000000000000000000000000000000000000000000000010E10000000000000000000000001
1111111111111111111111111111111111111111111111111111111111111111111111111111111111111111111111111111111111111111111111111111111111